30
10
#############################
#                      |    #
#          B      L    |  P #
#     #######################
#      |                    #
#      |   B                #  
###############----###      #
#                           #
#  E F                      #
###########++++##############