#############################
#                     |     #
#          B      L   | P P #
#     #######################
#      |                    #
#      |   B                #  
###############----###      #
#                           #
#  E F                      #
###########++++##############